##############
#    2       #
#1           #
######    4  #
#     2223333#
#    0       #
#    0       #
##############