###############
# 2 #         #
#   #         #
#   #  ####   #
#   #   1 #   #
#   #######   #
#             #
###############