##############################################
#   # #  #  #     #    #        #       #    #
# #   ## #     ## #5 #   #### # # ##### # ## #
# ## ##  #######  ########    ### #   # #  # # 
#  # #     #      #      # #### # ### # ## # #
## # ###     #           #      #  #  #    # # 
# 2#  #  ##############  # # #####    ###### #
##### # ##     #      # ## # #   ####   #    #
#     #    ### # #### #  ### # #    # # # ####
# ##  ######   #    # ## #   # # ## ### #  #6#
#  ####  #   ### #  # #  # ### #  #     ##   #
#          #   ### ## # ##     ## ############
################    # #1 #######    #    #   #
#                 ### #       #  ####  # #4# #
#  ####### ######## # ######  #  #     # ### #
#### #   # #  #       #       #  # ##### # # #
#    # #   #  # ##### # # ###### #   #   #   #
# ## # ##### ##     # # ###    # ### # #### ##
# #3 #   #    ##### # #     #  #     #    #  #
# ###### # ##     # # #######  ### # #### ## #
#        #  #####   #    #     #   #   #  #  #
## #######      # ######## ##### ##### # ## ##
#  #7#   ###### # #   #    #     #     #     #
# ## # # #    # # # # ### ## ### # ####### # #
#  #   #    #   #   #        #   #    #    # #
##############################################